0 0 0 0 0 0 0 0 0 0 0 0 0 0 0 0 0
0 0 0 0 0 0 0 0 0 0 0 0 0 0 0 0 0
0 0 0 0 0 0 0 0 0 0 0 0 0 0 0 0 0
8 8 8 8 8 8 8 8 8 8 8 8 8 8 8 8 8
8 8 8 8 8 8 8 8 8 8 8 8 8 8 8 8 8
8 8 8 8 8 8 8 8 8 8 8 8 8 8 8 8 8
8 7 7 0 0 7 7 7 7 7 7 7 0 0 7 7 8
8 6 6 0 0 6 6 6 6 6 6 6 0 0 6 6 8
8 5 5 0 0 5 5 5 5 5 5 5 0 0 5 5 8
8 4 4 0 0 4 4 4 4 4 4 4 0 0 4 4 8
8 3 3 0 0 3 3 3 3 3 3 3 0 0 3 3 8
8 2 2 0 0 2 2 2 2 2 2 2 0 0 2 2 8
8 7 7 0 0 7 7 7 7 7 7 7 0 0 7 7 8
8 6 6 0 0 6 6 6 6 6 6 6 0 0 6 6 8
8 5 5 0 0 5 5 5 5 5 5 5 0 0 5 5 8
8 4 4 0 0 4 4 4 4 4 4 4 0 0 4 4 8
8 3 3 0 0 3 3 3 3 3 3 3 0 0 3 3 8
8 2 2 0 0 2 2 2 2 2 2 2 0 0 2 2 8
8 7 7 0 0 7 7 7 7 7 7 7 0 0 7 7 8
8 6 6 0 0 6 6 6 6 6 6 6 0 0 6 6 8
8 5 5 0 0 5 5 5 5 5 5 5 0 0 5 5 8
8 4 4 0 0 4 4 4 4 4 4 4 0 0 4 4 8
8 3 3 0 0 3 3 3 3 3 3 3 0 0 3 3 8
8 2 2 0 0 2 2 2 2 2 2 2 0 0 2 2 8
8 0 0 0 0 0 0 0 0 0 0 0 0 0 0 0 8
8 0 0 0 0 0 0 0 0 0 0 0 0 0 0 0 8
8 0 0 0 0 0 0 0 0 0 0 0 0 0 0 0 8
8 0 0 0 0 0 0 0 0 0 0 0 0 0 0 0 8
8 0 0 0 0 0 0 0 0 0 0 0 0 0 0 0 8
8 0 0 0 0 0 0 0 0 0 0 0 0 0 0 0 8
8 0 0 0 0 0 0 0 0 0 0 0 0 0 0 0 8
8 0 0 0 0 0 0 0 0 0 0 0 0 0 0 0 8
8 0 0 0 0 0 0 0 0 0 0 0 0 0 0 0 8
8 0 0 0 0 0 0 0 0 0 0 0 0 0 0 0 8
8 0 0 0 0 0 0 0 0 0 0 0 0 0 0 0 8
8 0 0 0 0 0 0 0 0 0 0 0 0 0 0 0 8
8 0 0 0 0 0 0 0 0 0 0 0 0 0 0 0 8
8 0 0 0 0 0 0 0 0 0 0 0 0 0 0 0 8
8 0 0 0 0 0 0 0 0 0 0 0 0 0 0 0 8
8 0 0 0 0 0 0 0 0 0 0 0 0 0 0 0 8